{
  "id": "dark_cave",
  "name": "幽暗洞穴",
  "width": 60,
  "height": 60,
  "tile_size": 32,
  "metadata": {"level_range": [5, 12], "region": "cave", "environment": {"particles": [], "ambient_color": "rgba(0, 0, 30, 0.15)", "danger_zone": true}, "map_names": {"forest": "幽暗森林"}},
  "layers": {
    "ground": [
      [4, 4, 4, 4, 4, 4, 4, 4, 4, 4, 4, 4, 4, 4, 4, 4, 4, 4, 4, 4, 4, 4, 4, 4, 4, 4, 4, 4, 4, 4, 4, 4, 4, 4, 4, 4, 4, 4, 4, 4, 4, 4, 4, 4, 4, 4, 4, 4, 4, 4, 4, 4, 4, 4, 4, 4, 4, 4, 4, 4],
      [4, 4, 4, 4, 4, 4, 4, 4, 4, 4, 4, 4, 4, 4, 4, 4, 4, 4, 4, 4, 4, 4, 4, 4, 4, 4, 4, 4, 4, 4, 10, 10, 4, 4, 4, 4, 4, 4, 4, 4, 4, 4, 4, 4, 4, 4, 4, 4, 4, 4, 4, 4, 4, 4, 4, 4, 4, 4, 4, 4],
      [4, 4, 14, 14, 14, 14, 14, 14, 14, 14, 14, 14, 14, 14, 14, 14, 14, 14, 14, 14, 14, 14, 14, 14, 14, 14, 14, 14, 14, 14, 10, 10, 14, 14, 14, 14, 14, 14, 14, 14, 14, 14, 14, 14, 14, 14, 14, 14, 14, 14, 14, 14, 14, 14, 14, 14, 14, 14, 4, 4],
      [4, 4, 14, 14, 14, 14, 14, 14, 14, 31, 14, 14, 14, 14, 14, 14, 14, 14, 14, 14, 14, 14, 14, 14, 14, 14, 14, 14, 14, 14, 10, 10, 14, 14, 14, 14, 14, 14, 14, 14, 31, 14, 14, 14, 14, 14, 14, 14, 14, 14, 14, 14, 14, 14, 14, 14, 14, 14, 4, 4],
      [4, 4, 14, 14, 14, 14, 14, 14, 14, 14, 14, 14, 14, 14, 14, 14, 14, 14, 14, 14, 14, 14, 14, 14, 14, 14, 14, 14, 14, 14, 10, 10, 14, 14, 14, 14, 14, 14, 14, 14, 14, 14, 14, 14, 14, 14, 14, 14, 14, 14, 14, 14, 31, 14, 14, 14, 14, 14, 4, 4],
      [4, 4, 14, 14, 14, 14, 14, 14, 14, 14, 14, 14, 14, 14, 14, 14, 14, 14, 14, 14, 14, 14, 14, 14, 14, 14, 14, 14, 14, 14, 10, 10, 14, 14, 14, 14, 14, 14, 14, 14, 14, 14, 14, 14, 14, 14, 14, 14, 14, 14, 14, 14, 14, 14, 14, 14, 14, 14, 4, 4],
      [4, 4, 14, 14, 14, 14, 14, 14, 14, 14, 14, 14, 14, 14, 14, 14, 14, 14, 14, 14, 14, 14, 14, 14, 14, 14, 14, 14, 14, 14, 10, 10, 14, 14, 14, 14, 14, 14, 14, 14, 14, 14, 14, 14, 14, 14, 14, 14, 14, 14, 14, 14, 14, 14, 14, 14, 14, 14, 4, 4],
      [4, 4, 14, 14, 14, 14, 14, 14, 14, 14, 14, 14, 14, 14, 14, 14, 31, 14, 14, 14, 14, 14, 14, 14, 14, 14, 14, 14, 31, 14, 10, 10, 14, 14, 31, 14, 14, 14, 14, 14, 14, 14, 14, 14, 14, 14, 14, 14, 14, 14, 14, 14, 14, 14, 14, 14, 14, 14, 4, 4],
      [4, 4, 14, 14, 14, 14, 14, 14, 14, 14, 14, 14, 14, 14, 14, 14, 14, 14, 14, 14, 14, 14, 14, 14, 14, 14, 14, 14, 14, 14, 10, 10, 10, 14, 14, 14, 14, 14, 14, 14, 14, 14, 14, 14, 14, 14, 14, 14, 14, 14, 14, 14, 14, 14, 14, 14, 14, 14, 4, 4],
      [4, 4, 14, 14, 14, 14, 14, 14, 14, 14, 14, 14, 14, 14, 14, 14, 14, 14, 14, 14, 14, 14, 14, 14, 14, 14, 14, 14, 14, 10, 10, 10, 10, 10, 14, 14, 14, 14, 14, 14, 14, 14, 14, 14, 14, 14, 14, 14, 14, 14, 14, 14, 14, 14, 14, 14, 14, 14, 4, 4],
      [4, 4, 14, 14, 14, 14, 14, 14, 14, 14, 14, 14, 14, 14, 14, 14, 14, 14, 14, 14, 14, 14, 14, 14, 14, 14, 14, 14, 14, 14, 10, 10, 14, 14, 14, 14, 14, 14, 14, 14, 14, 14, 14, 14, 14, 14, 14, 14, 14, 31, 14, 14, 14, 14, 14, 14, 14, 14, 4, 4],
      [4, 4, 14, 14, 14, 14, 14, 14, 14, 14, 14, 14, 14, 14, 14, 14, 14, 14, 14, 14, 14, 14, 14, 14, 14, 14, 14, 14, 14, 14, 10, 10, 14, 14, 14, 14, 14, 14, 14, 14, 14, 14, 14, 14, 14, 14, 14, 14, 14, 14, 14, 14, 14, 14, 14, 14, 14, 14, 4, 4],
      [4, 4, 14, 14, 14, 14, 14, 14, 14, 14, 14, 14, 14, 14, 14, 14, 14, 14, 14, 14, 14, 14, 14, 14, 14, 14, 14, 14, 14, 14, 10, 10, 14, 14, 14, 14, 14, 14, 14, 14, 14, 14, 14, 14, 14, 14, 14, 14, 14, 14, 14, 14, 14, 14, 14, 14, 14, 14, 4, 4],
      [4, 4, 14, 14, 14, 14, 14, 14, 14, 14, 14, 14, 14, 14, 14, 14, 14, 14, 14, 14, 14, 14, 14, 14, 14, 14, 14, 14, 14, 14, 10, 10, 14, 14, 14, 14, 14, 14, 14, 14, 14, 14, 14, 14, 14, 14, 14, 14, 14, 14, 14, 14, 14, 14, 14, 14, 14, 14, 4, 4],
      [4, 4, 4, 4, 4, 4, 4, 4, 4, 4, 10, 10, 4, 4, 4, 4, 4, 4, 4, 4, 4, 4, 4, 4, 4, 4, 4, 4, 4, 4, 10, 10, 4, 4, 4, 4, 4, 4, 4, 4, 4, 4, 4, 4, 4, 4, 4, 4, 4, 4, 10, 10, 4, 4, 4, 4, 4, 4, 4, 4],
      [4, 4, 14, 14, 14, 14, 14, 14, 14, 14, 10, 10, 14, 14, 14, 14, 14, 14, 14, 14, 4, 14, 14, 14, 14, 14, 14, 14, 14, 14, 10, 10, 14, 14, 14, 14, 14, 14, 14, 4, 14, 14, 14, 14, 14, 14, 14, 14, 14, 14, 10, 10, 14, 14, 14, 14, 14, 14, 4, 4],
      [4, 4, 14, 14, 14, 14, 14, 14, 14, 14, 10, 10, 14, 14, 14, 14, 14, 14, 14, 14, 4, 14, 14, 14, 14, 14, 14, 14, 14, 14, 10, 10, 14, 14, 14, 14, 8, 14, 14, 4, 14, 14, 14, 20, 14, 14, 14, 14, 14, 14, 10, 10, 14, 14, 14, 14, 14, 14, 4, 4],
      [4, 4, 14, 14, 14, 14, 14, 14, 14, 14, 10, 10, 14, 14, 14, 14, 14, 14, 14, 14, 4, 14, 14, 14, 14, 14, 14, 14, 14, 14, 10, 10, 14, 14, 14, 14, 14, 14, 14, 4, 14, 14, 14, 14, 14, 14, 14, 14, 14, 14, 10, 10, 14, 14, 14, 14, 14, 14, 4, 4],
      [4, 4, 14, 14, 14, 14, 14, 14, 14, 14, 10, 10, 14, 14, 14, 14, 14, 14, 14, 14, 4, 14, 14, 14, 14, 14, 14, 14, 14, 14, 10, 10, 14, 14, 14, 14, 14, 14, 14, 4, 14, 14, 14, 14, 14, 14, 14, 14, 14, 14, 10, 10, 20, 14, 14, 14, 14, 14, 4, 4],
      [4, 4, 14, 14, 14, 14, 14, 14, 14, 14, 10, 10, 14, 14, 14, 14, 14, 14, 14, 14, 4, 14, 14, 14, 14, 14, 14, 14, 14, 14, 10, 10, 14, 14, 14, 14, 14, 14, 14, 4, 14, 14, 14, 14, 14, 14, 14, 14, 14, 14, 10, 10, 14, 14, 14, 14, 14, 14, 4, 4],
      [4, 4, 14, 14, 14, 14, 14, 14, 14, 14, 10, 10, 14, 14, 14, 14, 14, 14, 14, 14, 4, 14, 14, 14, 14, 14, 14, 14, 14, 14, 10, 10, 14, 14, 14, 8, 14, 14, 14, 4, 14, 14, 14, 20, 14, 14, 14, 14, 14, 14, 10, 10, 14, 14, 14, 20, 14, 14, 4, 4],
      [4, 4, 14, 14, 14, 14, 14, 14, 14, 14, 10, 10, 14, 14, 14, 14, 14, 14, 14, 14, 4, 14, 14, 14, 14, 14, 14, 14, 8, 14, 10, 10, 8, 14, 14, 14, 14, 14, 14, 4, 14, 14, 20, 14, 14, 14, 14, 14, 14, 14, 10, 10, 14, 14, 14, 14, 14, 14, 4, 4],
      [4, 4, 14, 14, 8, 14, 14, 14, 14, 14, 10, 10, 14, 14, 14, 14, 14, 14, 14, 14, 4, 14, 14, 14, 14, 14, 14, 14, 14, 14, 10, 10, 14, 14, 14, 14, 14, 14, 14, 4, 14, 14, 14, 14, 14, 14, 14, 14, 14, 14, 10, 10, 14, 14, 14, 14, 14, 14, 4, 4],
      [4, 4, 14, 14, 14, 14, 14, 14, 14, 14, 10, 10, 14, 14, 14, 14, 14, 14, 14, 14, 4, 14, 14, 14, 14, 14, 14, 14, 14, 14, 10, 10, 14, 14, 14, 14, 8, 14, 14, 4, 14, 14, 14, 14, 14, 14, 14, 20, 14, 14, 10, 10, 14, 14, 14, 14, 14, 14, 4, 4],
      [4, 4, 14, 14, 8, 14, 14, 14, 14, 8, 10, 10, 14, 14, 14, 14, 14, 14, 14, 14, 4, 14, 14, 14, 14, 14, 14, 14, 14, 14, 10, 10, 14, 8, 14, 14, 14, 14, 14, 4, 14, 14, 14, 14, 14, 14, 14, 14, 14, 14, 10, 10, 14, 14, 14, 14, 14, 14, 4, 4],
      [4, 4, 14, 8, 14, 14, 14, 14, 14, 14, 10, 10, 8, 14, 14, 14, 14, 14, 14, 14, 4, 14, 14, 14, 14, 14, 14, 14, 14, 14, 10, 10, 14, 14, 14, 14, 14, 14, 14, 4, 14, 14, 14, 14, 20, 14, 14, 14, 14, 14, 10, 10, 14, 14, 14, 14, 14, 14, 4, 4],
      [4, 4, 14, 14, 14, 14, 14, 14, 14, 14, 10, 10, 14, 14, 8, 14, 14, 14, 14, 14, 4, 14, 14, 14, 14, 8, 14, 14, 14, 14, 10, 10, 14, 8, 14, 14, 14, 14, 14, 4, 14, 14, 14, 14, 14, 14, 14, 14, 14, 14, 10, 10, 20, 14, 14, 14, 14, 14, 4, 4],
      [4, 4, 14, 14, 8, 14, 14, 14, 14, 14, 10, 10, 14, 14, 14, 14, 14, 14, 14, 14, 4, 14, 14, 14, 14, 14, 14, 14, 14, 14, 10, 10, 14, 14, 14, 14, 14, 14, 14, 4, 14, 14, 14, 14, 14, 14, 14, 20, 14, 14, 10, 10, 14, 14, 14, 14, 14, 14, 4, 4],
      [4, 4, 14, 14, 14, 14, 14, 14, 14, 14, 10, 10, 14, 14, 14, 14, 14, 14, 14, 14, 4, 14, 14, 14, 14, 14, 14, 14, 14, 14, 10, 10, 14, 14, 14, 14, 14, 14, 14, 4, 14, 14, 14, 14, 14, 14, 14, 14, 14, 14, 10, 10, 14, 14, 14, 14, 14, 14, 4, 4],
      [4, 4, 14, 14, 14, 14, 14, 14, 14, 14, 10, 10, 14, 14, 14, 14, 14, 14, 14, 14, 4, 14, 14, 14, 14, 14, 14, 14, 14, 14, 10, 10, 14, 14, 14, 14, 14, 14, 14, 4, 14, 14, 14, 14, 14, 14, 14, 14, 14, 14, 10, 10, 14, 14, 14, 14, 14, 14, 4, 4],
      [4, 4, 14, 14, 14, 14, 14, 14, 14, 14, 10, 10, 14, 14, 14, 14, 14, 14, 14, 14, 4, 14, 14, 14, 14, 14, 14, 14, 14, 14, 10, 10, 14, 14, 14, 14, 14, 14, 14, 4, 14, 14, 14, 14, 14, 14, 14, 14, 14, 14, 10, 10, 14, 14, 14, 14, 14, 14, 4, 4],
      [4, 4, 14, 14, 14, 14, 14, 14, 14, 14, 10, 10, 14, 14, 14, 14, 14, 8, 14, 14, 4, 14, 14, 14, 14, 14, 14, 14, 14, 14, 10, 10, 14, 14, 14, 14, 14, 14, 14, 4, 14, 14, 14, 14, 14, 14, 14, 14, 14, 14, 10, 10, 14, 14, 14, 14, 14, 14, 4, 4],
      [4, 4, 14, 14, 14, 8, 14, 14, 14, 14, 10, 10, 14, 14, 14, 8, 14, 14, 14, 14, 4, 14, 14, 14, 14, 14, 14, 14, 14, 14, 10, 10, 14, 14, 14, 14, 14, 14, 14, 4, 14, 14, 14, 14, 14, 14, 14, 14, 14, 14, 10, 10, 14, 14, 14, 14, 14, 14, 4, 4],
      [4, 4, 14, 14, 14, 14, 14, 14, 14, 14, 10, 10, 14, 14, 14, 14, 14, 14, 14, 14, 4, 14, 14, 14, 14, 14, 14, 14, 14, 14, 10, 10, 14, 14, 14, 14, 14, 14, 14, 4, 14, 14, 14, 14, 20, 14, 14, 14, 14, 14, 10, 10, 14, 14, 14, 14, 14, 14, 4, 4],
      [4, 4, 14, 14, 14, 14, 14, 14, 14, 14, 10, 10, 14, 14, 14, 14, 14, 14, 14, 14, 4, 14, 14, 14, 14, 14, 14, 14, 14, 14, 10, 10, 14, 14, 14, 14, 14, 14, 14, 4, 14, 14, 14, 14, 14, 14, 14, 14, 14, 14, 10, 10, 14, 14, 14, 14, 14, 14, 4, 4],
      [4, 4, 4, 4, 4, 4, 4, 4, 4, 4, 10, 10, 4, 4, 4, 4, 4, 4, 4, 4, 4, 4, 4, 4, 4, 4, 4, 4, 4, 4, 10, 10, 4, 4, 4, 4, 4, 4, 4, 4, 4, 4, 4, 4, 4, 4, 4, 4, 4, 4, 10, 10, 4, 4, 4, 4, 4, 4, 4, 4],
      [4, 4, 14, 14, 14, 14, 14, 14, 14, 14, 10, 10, 14, 14, 14, 14, 14, 14, 14, 14, 14, 14, 14, 14, 14, 14, 14, 14, 14, 14, 10, 10, 14, 14, 14, 14, 14, 14, 14, 14, 14, 14, 14, 14, 14, 14, 14, 14, 14, 14, 10, 10, 14, 14, 14, 14, 14, 14, 4, 4],
      [4, 4, 14, 14, 14, 14, 14, 14, 14, 14, 10, 10, 14, 14, 14, 14, 14, 14, 14, 14, 14, 14, 14, 14, 14, 14, 14, 14, 14, 14, 14, 14, 14, 14, 14, 14, 14, 14, 14, 14, 14, 14, 14, 14, 14, 14, 14, 14, 14, 14, 10, 10, 14, 14, 14, 14, 14, 14, 4, 4],
      [4, 4, 14, 14, 14, 14, 14, 14, 14, 14, 10, 10, 14, 14, 14, 14, 14, 14, 14, 14, 23, 14, 14, 14, 14, 14, 14, 14, 14, 14, 14, 14, 14, 14, 14, 14, 14, 14, 14, 14, 14, 23, 14, 14, 14, 14, 23, 14, 14, 14, 10, 10, 14, 14, 14, 14, 14, 14, 4, 4],
      [4, 4, 14, 14, 14, 14, 14, 14, 14, 14, 10, 10, 14, 14, 14, 14, 14, 14, 14, 14, 14, 14, 14, 14, 14, 14, 14, 14, 14, 14, 14, 14, 14, 14, 14, 14, 14, 14, 14, 14, 14, 14, 14, 14, 14, 14, 14, 14, 14, 14, 10, 10, 14, 14, 14, 14, 14, 14, 4, 4],
      [4, 4, 14, 14, 14, 14, 14, 14, 14, 14, 10, 10, 14, 14, 14, 14, 14, 14, 14, 14, 14, 14, 14, 14, 14, 14, 14, 14, 14, 14, 14, 14, 14, 14, 14, 14, 14, 14, 14, 14, 14, 14, 14, 14, 14, 14, 14, 14, 14, 14, 10, 10, 14, 14, 14, 14, 14, 14, 4, 4],
      [4, 4, 14, 14, 14, 14, 14, 23, 14, 14, 10, 10, 14, 14, 14, 14, 14, 14, 14, 14, 14, 14, 14, 14, 14, 14, 14, 14, 14, 14, 14, 14, 14, 14, 14, 14, 14, 14, 14, 14, 14, 14, 14, 14, 14, 14, 14, 14, 14, 14, 10, 10, 14, 14, 14, 14, 14, 14, 4, 4],
      [4, 4, 14, 14, 14, 14, 14, 14, 14, 14, 10, 10, 14, 14, 14, 14, 14, 14, 23, 14, 14, 14, 14, 14, 23, 14, 14, 14, 14, 14, 14, 14, 14, 14, 14, 14, 14, 14, 14, 14, 14, 14, 14, 14, 14, 14, 14, 14, 14, 14, 10, 10, 14, 14, 14, 14, 14, 14, 4, 4],
      [4, 4, 14, 14, 14, 14, 14, 14, 14, 14, 10, 10, 14, 14, 14, 14, 14, 14, 14, 14, 14, 14, 14, 14, 14, 14, 14, 14, 14, 14, 14, 14, 14, 14, 14, 14, 14, 14, 14, 14, 14, 14, 14, 14, 14, 14, 14, 14, 14, 14, 10, 10, 14, 14, 14, 14, 14, 14, 4, 4],
      [4, 4, 4, 4, 4, 4, 4, 4, 4, 4, 10, 10, 4, 4, 4, 4, 4, 4, 4, 4, 4, 4, 4, 4, 4, 4, 4, 4, 4, 4, 4, 4, 4, 4, 4, 4, 4, 4, 4, 4, 4, 4, 4, 4, 4, 4, 4, 4, 4, 4, 10, 10, 4, 4, 4, 4, 4, 4, 4, 4],
      [4, 4, 4, 4, 4, 4, 4, 4, 4, 4, 10, 10, 10, 10, 10, 14, 14, 14, 14, 14, 14, 14, 14, 14, 14, 14, 14, 14, 14, 14, 14, 14, 14, 14, 14, 14, 14, 14, 14, 14, 14, 14, 14, 14, 14, 14, 14, 10, 10, 10, 10, 10, 4, 4, 4, 4, 4, 4, 4, 4],
      [4, 4, 4, 4, 4, 4, 4, 4, 4, 4, 10, 10, 10, 10, 10, 10, 10, 10, 10, 14, 14, 14, 14, 14, 14, 14, 14, 14, 14, 14, 14, 14, 14, 14, 14, 14, 14, 14, 14, 14, 14, 14, 14, 10, 10, 10, 10, 10, 10, 10, 10, 10, 4, 4, 4, 4, 4, 4, 4, 4],
      [4, 4, 4, 4, 4, 4, 4, 4, 4, 4, 14, 14, 14, 14, 10, 10, 10, 10, 10, 10, 10, 10, 10, 14, 14, 14, 14, 13, 13, 34, 13, 13, 14, 14, 14, 14, 14, 14, 14, 10, 10, 10, 10, 10, 10, 10, 10, 10, 14, 14, 4, 4, 4, 4, 4, 4, 4, 4, 4, 4],
      [4, 4, 4, 4, 4, 4, 4, 4, 4, 4, 14, 14, 14, 14, 14, 14, 14, 14, 10, 10, 10, 10, 10, 10, 10, 10, 10, 13, 14, 14, 14, 13, 14, 14, 14, 10, 10, 10, 10, 10, 10, 10, 10, 10, 14, 14, 14, 14, 14, 14, 4, 4, 4, 4, 4, 4, 4, 4, 4, 4],
      [4, 4, 4, 4, 4, 4, 4, 4, 4, 4, 14, 14, 14, 14, 14, 14, 14, 14, 14, 14, 14, 14, 10, 10, 10, 10, 10, 10, 10, 10, 10, 10, 10, 10, 10, 10, 10, 10, 10, 10, 14, 14, 14, 14, 14, 14, 14, 14, 14, 14, 4, 4, 4, 4, 4, 4, 4, 4, 4, 4],
      [4, 4, 4, 4, 4, 4, 4, 4, 4, 4, 14, 14, 14, 14, 14, 14, 14, 14, 14, 14, 14, 14, 14, 14, 14, 14, 10, 10, 10, 10, 10, 10, 10, 10, 10, 10, 14, 14, 14, 14, 14, 14, 14, 14, 14, 14, 14, 14, 14, 14, 4, 4, 4, 4, 4, 4, 4, 4, 4, 4],
      [4, 4, 4, 4, 4, 4, 4, 4, 4, 4, 14, 14, 14, 14, 14, 14, 14, 14, 14, 14, 14, 14, 14, 14, 14, 14, 14, 14, 14, 14, 10, 10, 14, 14, 14, 14, 14, 14, 14, 14, 14, 14, 14, 14, 14, 14, 14, 31, 14, 14, 4, 4, 4, 4, 4, 4, 4, 4, 4, 4],
      [4, 4, 4, 4, 4, 4, 4, 4, 4, 4, 14, 14, 14, 14, 14, 14, 14, 14, 14, 14, 14, 14, 14, 14, 14, 14, 14, 14, 14, 14, 14, 14, 14, 31, 14, 14, 14, 14, 14, 14, 14, 14, 14, 14, 14, 14, 14, 14, 14, 14, 4, 4, 4, 4, 4, 4, 4, 4, 4, 4],
      [4, 4, 4, 4, 4, 4, 4, 4, 4, 4, 14, 14, 14, 14, 14, 14, 14, 14, 14, 14, 14, 14, 14, 14, 14, 14, 14, 14, 14, 14, 14, 14, 14, 14, 14, 14, 14, 14, 14, 14, 14, 14, 14, 14, 14, 14, 14, 14, 14, 14, 4, 4, 4, 4, 4, 4, 4, 4, 4, 4],
      [4, 4, 4, 4, 4, 4, 4, 4, 4, 4, 14, 14, 14, 14, 14, 14, 14, 14, 14, 14, 14, 14, 14, 14, 14, 14, 14, 14, 14, 14, 14, 14, 14, 14, 14, 14, 14, 14, 14, 14, 14, 14, 14, 14, 14, 14, 14, 14, 14, 14, 4, 4, 4, 4, 4, 4, 4, 4, 4, 4],
      [4, 4, 4, 4, 4, 4, 4, 4, 4, 4, 14, 14, 14, 14, 14, 14, 14, 14, 14, 14, 14, 14, 14, 14, 14, 14, 14, 14, 14, 14, 14, 14, 14, 14, 14, 14, 14, 14, 14, 14, 14, 14, 14, 14, 14, 14, 14, 14, 14, 14, 4, 4, 4, 4, 4, 4, 4, 4, 4, 4],
      [4, 4, 4, 4, 4, 4, 4, 4, 4, 4, 14, 31, 14, 14, 14, 14, 14, 14, 14, 14, 14, 14, 14, 14, 14, 14, 14, 14, 14, 14, 14, 31, 14, 14, 14, 14, 14, 14, 14, 14, 14, 14, 14, 14, 14, 14, 14, 14, 14, 14, 4, 4, 4, 4, 4, 4, 4, 4, 4, 4],
      [4, 4, 4, 4, 4, 4, 4, 4, 4, 4, 14, 14, 14, 14, 14, 14, 14, 14, 14, 14, 14, 14, 14, 14, 14, 14, 14, 14, 14, 14, 14, 14, 14, 14, 14, 14, 14, 14, 14, 14, 14, 14, 14, 14, 14, 14, 14, 14, 14, 14, 4, 4, 4, 4, 4, 4, 4, 4, 4, 4],
      [4, 4, 4, 4, 4, 4, 4, 4, 4, 4, 4, 4, 4, 4, 4, 4, 4, 4, 4, 4, 4, 4, 4, 4, 4, 4, 4, 4, 4, 4, 4, 4, 4, 4, 4, 4, 4, 4, 4, 4, 4, 4, 4, 4, 4, 4, 4, 4, 4, 4, 4, 4, 4, 4, 4, 4, 4, 4, 4, 4],
      [4, 4, 4, 4, 4, 4, 4, 4, 4, 4, 4, 4, 4, 4, 4, 4, 4, 4, 4, 4, 4, 4, 4, 4, 4, 4, 4, 4, 4, 4, 4, 4, 4, 4, 4, 4, 4, 4, 4, 4, 4, 4, 4, 4, 4, 4, 4, 4, 4, 4, 4, 4, 4, 4, 4, 4, 4, 4, 4, 4]
    ]
  },
  "objects": [],
  "npcs": [],
  "monster_groups": [],
  "player_spawn": {"x": 30, "y": 5}
}