{
  "id": "forest",
  "name": "幽暗森林",
  "width": 60,
  "height": 50,
  "tile_size": 32,
  "layers": {
    "ground": [
      [4, 4, 4, 4, 4, 4, 4, 4, 4, 4, 4, 4, 4, 4, 4, 4, 4, 4, 4, 4, 4, 4, 4, 4, 4, 4, 4, 4, 4, 4, 4, 4, 4, 4, 4, 4, 4, 4, 4, 4, 4, 4, 4, 4, 4, 4, 4, 4, 4, 4, 4, 4, 4, 4, 4, 4, 4, 4, 4, 4],
      [4, 4, 4, 4, 4, 4, 4, 4, 4, 4, 4, 4, 4, 4, 4, 4, 4, 4, 4, 4, 4, 4, 4, 4, 4, 4, 4, 4, 4, 4, 4, 4, 4, 4, 4, 4, 4, 4, 4, 4, 4, 4, 4, 4, 4, 4, 4, 4, 4, 4, 4, 4, 4, 4, 4, 4, 4, 4, 4, 4],
      [4, 4, 9, 9, 9, 9, 9, 9, 9, 9, 9, 9, 9, 9, 9, 9, 9, 9, 9, 9, 9, 9, 9, 9, 9, 9, 9, 9, 9, 9, 1, 1, 9, 9, 9, 9, 9, 9, 9, 9, 9, 9, 9, 9, 9, 9, 9, 9, 9, 9, 9, 9, 9, 9, 9, 9, 9, 9, 4, 4],
      [4, 4, 9, 9, 5, 9, 5, 9, 9, 9, 9, 9, 9, 9, 9, 9, 9, 9, 9, 5, 5, 9, 9, 9, 9, 9, 9, 9, 5, 9, 1, 1, 9, 9, 5, 5, 5, 9, 9, 9, 9, 9, 9, 9, 5, 5, 5, 9, 9, 9, 9, 9, 9, 9, 9, 9, 9, 9, 4, 4],
      [4, 4, 9, 5, 9, 9, 5, 5, 9, 9, 9, 9, 9, 9, 9, 9, 9, 9, 9, 9, 5, 9, 9, 9, 9, 9, 9, 9, 5, 5, 1, 1, 9, 9, 5, 9, 5, 9, 9, 9, 9, 9, 9, 9, 5, 9, 5, 9, 9, 9, 9, 9, 9, 9, 9, 9, 9, 9, 4, 4],
      [4, 4, 9, 5, 9, 9, 5, 9, 9, 9, 9, 9, 9, 9, 9, 1, 9, 9, 9, 9, 9, 9, 9, 9, 9, 9, 9, 9, 5, 5, 1, 1, 9, 9, 5, 5, 5, 9, 9, 9, 9, 9, 9, 9, 9, 9, 9, 9, 9, 9, 9, 9, 9, 9, 9, 9, 9, 9, 4, 4],
      [4, 4, 9, 9, 9, 9, 9, 9, 9, 9, 9, 9, 9, 9, 9, 5, 9, 9, 9, 9, 9, 9, 9, 9, 9, 9, 9, 9, 9, 9, 1, 1, 9, 9, 9, 9, 9, 9, 9, 9, 9, 9, 9, 9, 9, 9, 9, 9, 5, 5, 5, 9, 9, 9, 9, 9, 9, 9, 4, 4],
      [4, 4, 9, 9, 9, 9, 9, 9, 9, 9, 9, 9, 9, 9, 9, 5, 9, 5, 9, 9, 9, 7, 9, 9, 5, 5, 5, 5, 9, 9, 1, 1, 9, 9, 9, 9, 9, 5, 5, 5, 9, 9, 9, 9, 9, 9, 9, 9, 9, 5, 5, 9, 9, 9, 9, 9, 9, 9, 4, 4],
      [4, 4, 9, 9, 9, 9, 9, 9, 9, 9, 9, 9, 9, 9, 9, 1, 9, 9, 9, 9, 9, 9, 9, 5, 9, 5, 9, 5, 9, 9, 1, 1, 9, 9, 9, 9, 9, 5, 9, 5, 9, 9, 9, 9, 9, 9, 9, 9, 9, 9, 5, 9, 9, 9, 9, 9, 9, 9, 4, 4],
      [4, 4, 9, 9, 9, 9, 9, 9, 9, 9, 5, 5, 9, 9, 9, 1, 9, 9, 9, 9, 9, 9, 9, 5, 5, 5, 5, 9, 9, 9, 1, 1, 9, 5, 5, 5, 9, 5, 5, 5, 9, 9, 9, 9, 9, 9, 9, 9, 9, 9, 9, 9, 9, 9, 9, 9, 9, 9, 4, 4],
      [4, 4, 9, 9, 9, 9, 9, 9, 9, 9, 5, 9, 9, 9, 9, 1, 9, 9, 9, 9, 9, 9, 9, 9, 9, 9, 9, 9, 9, 9, 1, 1, 9, 9, 5, 9, 9, 9, 9, 9, 9, 9, 9, 9, 9, 9, 9, 9, 9, 9, 9, 9, 9, 9, 9, 9, 9, 9, 4, 4],
      [4, 4, 9, 9, 9, 9, 9, 9, 9, 9, 9, 5, 5, 5, 5, 1, 9, 9, 9, 5, 9, 9, 9, 9, 9, 9, 9, 9, 5, 5, 1, 1, 9, 9, 9, 9, 9, 5, 9, 9, 9, 9, 9, 9, 5, 9, 9, 9, 9, 9, 9, 9, 9, 9, 9, 9, 5, 9, 4, 4],
      [4, 4, 9, 9, 9, 9, 9, 9, 9, 9, 9, 9, 9, 9, 5, 1, 9, 9, 9, 9, 5, 5, 9, 9, 9, 9, 9, 9, 9, 5, 1, 1, 9, 9, 9, 5, 5, 9, 5, 9, 9, 9, 9, 5, 9, 9, 9, 9, 9, 9, 9, 9, 9, 9, 9, 5, 5, 9, 4, 4],
      [4, 4, 9, 6, 9, 9, 9, 9, 9, 9, 9, 5, 5, 9, 5, 1, 9, 9, 9, 5, 9, 9, 9, 9, 9, 9, 9, 5, 9, 5, 1, 1, 9, 9, 5, 5, 5, 5, 5, 9, 9, 9, 9, 9, 5, 9, 9, 9, 9, 9, 9, 9, 9, 9, 9, 9, 5, 9, 4, 4],
      [4, 4, 9, 9, 9, 9, 9, 9, 9, 9, 9, 5, 9, 9, 9, 1, 9, 9, 9, 9, 9, 9, 9, 9, 9, 9, 9, 9, 9, 9, 1, 1, 9, 9, 9, 9, 9, 9, 9, 9, 9, 9, 9, 9, 9, 9, 9, 9, 9, 9, 9, 9, 9, 9, 9, 9, 9, 9, 4, 4],
      [4, 4, 9, 9, 9, 9, 9, 9, 9, 9, 9, 5, 5, 9, 9, 5, 9, 5, 9, 5, 9, 9, 9, 9, 9, 9, 9, 9, 9, 9, 1, 1, 9, 9, 9, 9, 9, 9, 9, 9, 9, 9, 9, 9, 9, 9, 9, 9, 9, 9, 9, 9, 9, 9, 9, 9, 9, 9, 4, 4],
      [4, 4, 9, 9, 9, 9, 9, 9, 9, 9, 9, 9, 9, 9, 9, 1, 9, 9, 9, 5, 5, 9, 9, 9, 9, 9, 9, 9, 9, 9, 1, 1, 9, 9, 9, 9, 9, 9, 9, 9, 9, 9, 9, 9, 9, 9, 6, 9, 9, 5, 5, 5, 9, 9, 9, 9, 9, 9, 4, 4],
      [4, 4, 9, 9, 9, 9, 9, 9, 9, 9, 9, 9, 9, 9, 1, 9, 9, 9, 9, 5, 5, 5, 9, 9, 9, 9, 9, 9, 9, 9, 1, 1, 9, 9, 9, 9, 9, 9, 9, 9, 9, 9, 9, 9, 9, 9, 9, 9, 9, 9, 5, 9, 9, 9, 9, 9, 9, 9, 4, 4],
      [4, 4, 9, 9, 9, 9, 9, 9, 9, 9, 9, 9, 9, 9, 9, 1, 9, 9, 5, 5, 5, 5, 9, 9, 9, 9, 9, 9, 9, 9, 1, 1, 9, 9, 9, 9, 9, 9, 9, 9, 9, 9, 9, 9, 9, 9, 9, 9, 9, 9, 9, 9, 9, 9, 9, 9, 9, 9, 4, 4],
      [4, 4, 9, 9, 9, 9, 9, 9, 9, 9, 9, 9, 9, 9, 1, 9, 9, 9, 5, 9, 9, 5, 9, 9, 9, 9, 9, 9, 9, 9, 1, 1, 9, 9, 9, 9, 9, 9, 9, 9, 9, 9, 9, 9, 9, 9, 9, 9, 9, 9, 9, 9, 9, 9, 9, 9, 9, 9, 4, 4],
      [4, 4, 9, 9, 9, 9, 9, 9, 9, 9, 9, 9, 9, 9, 1, 9, 9, 9, 5, 5, 5, 5, 9, 9, 9, 6, 9, 9, 0, 0, 0, 0, 0, 5, 9, 9, 9, 9, 9, 9, 0, 0, 0, 0, 0, 9, 9, 9, 9, 9, 9, 9, 5, 9, 9, 9, 9, 9, 4, 4],
      [4, 4, 9, 9, 9, 9, 9, 9, 9, 9, 5, 9, 9, 9, 1, 9, 9, 9, 9, 9, 9, 5, 5, 9, 9, 9, 9, 9, 0, 2, 2, 2, 0, 9, 9, 9, 5, 5, 9, 9, 0, 2, 2, 2, 0, 9, 9, 9, 9, 9, 9, 9, 6, 9, 9, 9, 9, 9, 4, 4],
      [4, 4, 9, 5, 9, 9, 9, 9, 9, 9, 9, 9, 9, 9, 9, 1, 9, 9, 9, 9, 5, 9, 5, 9, 9, 9, 9, 9, 0, 2, 2, 2, 0, 9, 9, 5, 5, 5, 9, 9, 0, 2, 2, 2, 0, 5, 9, 9, 9, 9, 9, 9, 9, 5, 9, 9, 9, 9, 4, 4],
      [4, 4, 9, 5, 5, 9, 9, 9, 9, 9, 9, 9, 9, 9, 9, 1, 9, 9, 9, 9, 9, 9, 9, 9, 9, 9, 9, 9, 0, 0, 0, 0, 0, 9, 5, 9, 5, 9, 9, 9, 0, 0, 0, 0, 0, 9, 9, 9, 5, 5, 9, 9, 9, 9, 9, 9, 9, 9, 4, 4],
      [4, 4, 9, 9, 5, 9, 9, 9, 9, 9, 9, 9, 9, 9, 1, 9, 9, 9, 9, 9, 9, 9, 9, 9, 9, 9, 9, 9, 9, 9, 1, 1, 9, 9, 9, 5, 9, 9, 9, 5, 9, 5, 9, 5, 9, 5, 9, 5, 9, 9, 9, 9, 9, 9, 9, 9, 9, 9, 4, 4],
      [4, 4, 1, 1, 1, 1, 1, 1, 1, 1, 1, 1, 1, 1, 1, 1, 1, 1, 1, 1, 1, 1, 1, 1, 1, 1, 1, 1, 1, 1, 1, 1, 1, 1, 1, 1, 1, 1, 1, 1, 1, 1, 1, 1, 1, 1, 1, 1, 1, 1, 1, 1, 1, 1, 1, 1, 1, 1, 4, 4],
      [4, 4, 1, 1, 1, 1, 1, 1, 1, 1, 1, 1, 1, 1, 1, 1, 1, 1, 1, 1, 1, 1, 1, 1, 1, 1, 1, 1, 1, 1, 1, 1, 1, 1, 1, 1, 1, 1, 1, 1, 1, 1, 1, 1, 1, 1, 1, 1, 1, 1, 1, 1, 1, 1, 1, 1, 1, 1, 4, 4],
      [4, 4, 9, 5, 9, 5, 9, 9, 9, 9, 9, 9, 9, 1, 9, 9, 5, 9, 9, 9, 9, 9, 9, 9, 9, 5, 5, 9, 9, 9, 1, 1, 9, 9, 9, 9, 9, 9, 5, 9, 9, 9, 9, 5, 5, 5, 9, 9, 9, 9, 9, 9, 9, 5, 9, 5, 9, 9, 4, 4],
      [4, 4, 9, 9, 5, 9, 9, 9, 9, 9, 9, 9, 9, 1, 9, 5, 9, 9, 9, 9, 9, 9, 9, 9, 9, 9, 9, 9, 9, 9, 1, 1, 9, 9, 9, 9, 5, 5, 5, 9, 9, 9, 5, 5, 5, 5, 9, 9, 9, 9, 9, 9, 9, 5, 9, 9, 9, 9, 4, 4],
      [4, 4, 9, 9, 9, 9, 9, 9, 9, 9, 9, 9, 9, 1, 9, 9, 9, 9, 9, 9, 9, 9, 9, 5, 9, 9, 9, 9, 9, 5, 1, 1, 9, 9, 9, 9, 5, 9, 5, 9, 9, 9, 9, 9, 9, 9, 9, 9, 9, 9, 5, 9, 9, 9, 9, 9, 9, 9, 4, 4],
      [4, 4, 9, 9, 9, 9, 9, 9, 9, 9, 9, 9, 5, 5, 5, 9, 9, 9, 9, 9, 9, 9, 9, 5, 9, 9, 9, 9, 9, 5, 1, 1, 9, 9, 9, 9, 9, 9, 9, 9, 9, 9, 9, 9, 9, 9, 9, 9, 5, 5, 9, 9, 9, 9, 9, 9, 9, 9, 4, 4],
      [4, 4, 9, 9, 9, 9, 9, 9, 9, 9, 9, 9, 5, 5, 9, 9, 9, 9, 5, 5, 9, 5, 5, 5, 9, 9, 9, 9, 9, 9, 1, 1, 9, 9, 9, 9, 9, 9, 9, 9, 9, 9, 9, 9, 9, 9, 9, 9, 5, 9, 5, 9, 9, 9, 9, 9, 9, 9, 4, 4],
      [4, 4, 9, 9, 9, 9, 9, 9, 5, 5, 9, 9, 5, 5, 9, 9, 5, 5, 5, 5, 5, 9, 9, 9, 9, 9, 9, 9, 9, 9, 1, 1, 9, 9, 9, 9, 9, 9, 9, 9, 9, 9, 9, 9, 9, 9, 9, 9, 9, 9, 9, 9, 9, 9, 9, 9, 9, 9, 4, 4],
      [4, 4, 9, 9, 9, 9, 9, 9, 9, 5, 5, 5, 9, 1, 9, 5, 9, 5, 5, 5, 5, 9, 9, 9, 9, 9, 9, 9, 9, 9, 1, 1, 5, 5, 5, 9, 9, 9, 9, 9, 9, 9, 9, 9, 9, 9, 5, 9, 5, 9, 9, 9, 6, 9, 9, 9, 9, 9, 4, 4],
      [4, 4, 9, 9, 9, 9, 9, 9, 9, 5, 9, 5, 9, 1, 9, 5, 5, 5, 5, 9, 5, 9, 9, 9, 9, 9, 9, 9, 9, 9, 1, 1, 9, 5, 5, 9, 5, 5, 5, 9, 9, 9, 9, 9, 9, 9, 5, 5, 5, 7, 9, 9, 9, 9, 9, 9, 9, 9, 4, 4],
      [4, 4, 9, 9, 9, 9, 9, 9, 9, 5, 5, 5, 9, 1, 9, 9, 9, 9, 9, 9, 9, 9, 9, 9, 9, 9, 9, 9, 9, 9, 1, 1, 5, 9, 9, 9, 9, 5, 5, 5, 5, 9, 9, 9, 9, 9, 5, 9, 5, 9, 5, 5, 9, 9, 9, 9, 9, 9, 4, 4],
      [4, 4, 9, 9, 9, 9, 9, 9, 9, 9, 9, 9, 9, 1, 9, 9, 9, 9, 5, 9, 9, 9, 9, 9, 9, 9, 9, 9, 9, 9, 1, 1, 9, 9, 9, 9, 9, 5, 5, 9, 5, 9, 9, 9, 9, 9, 9, 9, 9, 5, 5, 9, 9, 9, 9, 9, 9, 9, 4, 4],
      [4, 4, 9, 9, 9, 9, 9, 9, 9, 9, 9, 9, 9, 1, 9, 9, 9, 9, 9, 5, 5, 9, 9, 9, 9, 9, 9, 9, 9, 9, 1, 1, 9, 9, 9, 9, 9, 9, 9, 5, 5, 9, 9, 9, 9, 9, 9, 9, 9, 5, 5, 5, 5, 5, 9, 9, 9, 9, 4, 4],
      [4, 4, 9, 9, 9, 9, 9, 9, 9, 9, 9, 9, 9, 1, 9, 9, 9, 9, 9, 9, 5, 9, 9, 9, 6, 9, 9, 9, 9, 9, 1, 1, 9, 9, 9, 9, 9, 9, 9, 9, 9, 9, 9, 9, 9, 9, 9, 9, 9, 9, 9, 5, 5, 5, 9, 9, 9, 9, 4, 4],
      [4, 4, 9, 9, 9, 9, 9, 9, 9, 9, 9, 9, 9, 1, 9, 9, 9, 9, 9, 9, 9, 9, 9, 9, 9, 9, 9, 9, 9, 9, 1, 1, 9, 9, 9, 9, 9, 9, 9, 9, 9, 9, 9, 9, 9, 9, 9, 9, 9, 9, 9, 9, 9, 9, 9, 9, 9, 9, 4, 4],
      [4, 4, 9, 9, 9, 9, 9, 9, 9, 9, 9, 9, 9, 1, 9, 9, 9, 9, 9, 9, 9, 9, 9, 9, 9, 9, 9, 9, 9, 9, 1, 1, 9, 9, 9, 9, 9, 5, 5, 9, 9, 9, 9, 9, 9, 9, 9, 9, 9, 9, 9, 9, 9, 9, 9, 9, 9, 9, 4, 4],
      [4, 4, 9, 9, 9, 9, 9, 9, 9, 9, 9, 9, 9, 1, 9, 9, 9, 9, 9, 9, 9, 9, 9, 9, 9, 9, 9, 9, 9, 9, 1, 1, 9, 5, 5, 9, 9, 5, 7, 9, 9, 9, 9, 9, 9, 9, 9, 9, 9, 9, 9, 9, 9, 9, 9, 9, 9, 9, 4, 4],
      [4, 4, 9, 0, 0, 0, 0, 0, 9, 9, 9, 9, 9, 1, 9, 9, 9, 9, 9, 9, 9, 9, 9, 9, 6, 9, 9, 9, 9, 9, 1, 1, 9, 5, 5, 5, 9, 5, 5, 9, 9, 9, 9, 9, 9, 9, 9, 9, 9, 9, 9, 9, 6, 9, 9, 9, 9, 9, 4, 4],
      [4, 4, 9, 0, 2, 2, 2, 0, 5, 9, 5, 9, 5, 1, 9, 9, 9, 9, 9, 9, 9, 9, 9, 9, 9, 9, 9, 9, 9, 9, 1, 1, 9, 9, 9, 5, 9, 9, 9, 9, 9, 9, 9, 9, 9, 9, 9, 9, 9, 9, 9, 9, 9, 9, 9, 9, 9, 9, 4, 4],
      [4, 4, 9, 0, 2, 2, 2, 0, 6, 9, 5, 9, 5, 1, 9, 9, 9, 9, 9, 9, 9, 9, 9, 9, 9, 9, 9, 9, 9, 9, 1, 1, 9, 9, 9, 9, 9, 9, 9, 9, 9, 9, 9, 9, 9, 9, 9, 9, 9, 9, 9, 9, 9, 9, 9, 9, 9, 9, 4, 4],
      [4, 4, 9, 0, 0, 0, 0, 0, 9, 9, 5, 5, 9, 9, 9, 9, 9, 9, 9, 9, 9, 9, 9, 9, 9, 9, 9, 9, 9, 5, 1, 1, 9, 9, 9, 9, 5, 9, 9, 9, 9, 9, 5, 9, 9, 9, 9, 9, 9, 9, 9, 9, 9, 9, 9, 9, 9, 9, 4, 4],
      [4, 4, 9, 9, 5, 5, 5, 9, 9, 9, 5, 5, 5, 9, 9, 9, 9, 9, 9, 9, 9, 9, 9, 9, 9, 9, 9, 9, 9, 9, 1, 1, 9, 9, 9, 9, 9, 9, 9, 9, 5, 9, 5, 9, 9, 9, 9, 9, 9, 9, 9, 9, 9, 9, 9, 9, 9, 9, 4, 4],
      [4, 4, 9, 9, 9, 9, 9, 9, 9, 9, 9, 9, 9, 9, 9, 9, 9, 9, 9, 9, 9, 9, 9, 9, 9, 9, 9, 9, 9, 9, 1, 1, 9, 9, 9, 9, 9, 9, 9, 9, 9, 9, 9, 9, 9, 9, 9, 9, 9, 9, 9, 9, 9, 9, 9, 9, 9, 9, 4, 4],
      [4, 4, 4, 4, 4, 4, 4, 4, 4, 4, 4, 4, 4, 4, 4, 4, 4, 4, 4, 4, 4, 4, 4, 4, 4, 4, 4, 4, 4, 4, 4, 4, 4, 4, 4, 4, 4, 4, 4, 4, 4, 4, 4, 4, 4, 4, 4, 4, 4, 4, 4, 4, 4, 4, 4, 4, 4, 4, 4, 4],
      [4, 4, 4, 4, 4, 4, 4, 4, 4, 4, 4, 4, 4, 4, 4, 4, 4, 4, 4, 4, 4, 4, 4, 4, 4, 4, 4, 4, 4, 4, 4, 4, 4, 4, 4, 4, 4, 4, 4, 4, 4, 4, 4, 4, 4, 4, 4, 4, 4, 4, 4, 4, 4, 4, 4, 4, 4, 4, 4, 4]
    ]
  },
  "monsters": [
    {"monster_id": "slime", "x": 15, "y": 12},
    {"monster_id": "slime", "x": 22, "y": 8},
    {"monster_id": "wild_wolf", "x": 40, "y": 20, "patrol": [{"x": 38, "y": 20}, {"x": 42, "y": 20}, {"x": 42, "y": 24}]},
    {"monster_id": "wild_wolf", "x": 10, "y": 35, "patrol": [{"x": 8, "y": 35}, {"x": 14, "y": 35}]},
    {"monster_id": "forest_spider", "x": 48, "y": 30},
    {"monster_id": "goblin", "x": 35, "y": 40},
    {"monster_id": "dark_bear", "x": 50, "y": 15}
  ],
  "objects": [
    {
      "id": "portal_to_village",
      "type": "portal",
      "x": 30,
      "y": 26,
      "properties": {
        "target_map": "village",
        "target_x": 25,
        "target_y": 21
      }
    },
    {
      "id": "chest_forest_01",
      "type": "chest",
      "x": 40,
      "y": 35,
      "properties": {
        "items": [{"item_id": "health_potion", "quantity": 2}],
        "opened": false
      }
    },
    {
      "id": "herb_01",
      "type": "gather",
      "x": 15,
      "y": 20,
      "properties": {
        "item_id": "herb",
        "respawn_time": 60
      }
    },
    {
      "id": "herb_02",
      "type": "gather",
      "x": 45,
      "y": 40,
      "properties": {
        "item_id": "herb",
        "respawn_time": 60
      }
    }
  ],
  "npcs": [
    {
      "npc_id": "herbalist",
      "x": 20,
      "y": 30
    }
  ],
  "player_spawn": {"x": 30, "y": 25}
}