{
  "id": "village",
  "name": "青石村",
  "width": 25,
  "height": 18,
  "tile_size": 32,
  "layers": {
    "ground": [
      [4,4,4,4,4,4,4,4,4,4,4,4,4,4,4,4,4,4,4,4,4,4,4,4,4],
      [4,0,0,0,0,4,0,0,0,0,0,0,0,0,0,0,0,0,0,4,0,0,0,0,4],
      [4,0,0,0,0,0,0,0,0,0,0,0,0,0,0,0,0,0,0,0,0,0,0,0,4],
      [4,0,0,2,2,2,0,0,0,0,0,0,0,0,0,0,0,2,2,2,0,0,0,0,4],
      [4,0,0,2,6,2,0,0,0,1,1,1,1,1,0,0,0,2,9,2,0,0,0,0,4],
      [4,0,0,2,6,2,0,0,0,1,0,0,0,1,0,0,0,2,2,2,0,0,0,0,4],
      [4,0,0,2,2,2,0,0,0,1,0,0,0,1,0,0,0,0,0,0,0,0,0,0,4],
      [4,0,0,0,1,0,0,0,0,1,0,0,0,1,0,0,0,0,0,0,0,4,0,0,4],
      [4,0,0,0,1,0,0,0,0,1,1,1,1,1,0,0,0,0,0,0,0,0,0,0,4],
      [4,0,0,0,1,1,1,1,1,1,0,0,0,0,0,0,0,0,0,0,0,0,0,0,4],
      [4,0,0,0,0,0,0,0,0,1,0,0,0,0,0,0,0,2,2,2,0,0,0,0,4],
      [4,0,0,0,0,0,0,0,0,1,0,0,0,0,0,0,0,2,3,2,0,0,0,0,4],
      [4,0,0,0,0,0,7,7,0,1,0,0,0,0,0,0,0,2,2,2,0,0,0,0,4],
      [4,0,0,0,0,0,7,7,0,0,0,0,0,0,0,0,0,0,1,0,0,0,0,0,4],
      [4,0,0,0,0,0,0,0,0,0,0,0,8,0,0,0,0,0,1,0,0,0,0,0,4],
      [4,0,0,0,0,0,0,0,0,0,0,0,0,0,0,0,0,0,1,0,0,0,0,0,4],
      [4,0,0,0,0,0,0,0,0,0,0,0,0,0,0,0,0,0,0,0,0,0,0,0,4],
      [4,4,4,4,4,4,4,4,4,4,4,4,4,4,4,4,4,4,4,4,4,4,4,4,4]
    ]
  },
  "objects": [
    {
      "id": "portal_to_forest",
      "type": "portal",
      "x": 18,
      "y": 17,
      "properties": {
        "target_map": "forest",
        "target_x": 12,
        "target_y": 1
      }
    }
  ],
  "npcs": [
    {
      "npc_id": "blacksmith",
      "x": 4,
      "y": 5
    },
    {
      "npc_id": "merchant",
      "x": 18,
      "y": 5
    }
  ],
  "player_spawn": {
    "x": 9,
    "y": 9
  }
}
