{
  "id": "village",
  "name": "青石村",
  "width": 60,
  "height": 50,
  "tile_size": 32,
  "metadata": {"level_range": [1, 1], "region": "village", "environment": {"particles": [{"type": "leaf", "rate": 0.05}], "ambient_color": null, "danger_zone": false}, "map_names": {"forest": "幽暗森林", "dark_cave": "黑暗洞穴", "desert_oasis": "沙漠绿洲", "royal_city": "王城"}},
  "layers": {
    "ground": [
      [4, 4, 4, 4, 4, 4, 4, 4, 4, 4, 4, 4, 4, 4, 4, 4, 4, 4, 4, 4, 4, 4, 4, 4, 4, 4, 4, 4, 4, 4, 4, 4, 4, 4, 4, 4, 4, 4, 4, 4, 4, 4, 4, 4, 4, 4, 4, 4, 4, 4, 4, 4, 4, 4, 4, 4, 4, 4, 4, 4],
      [4, 4, 4, 4, 4, 4, 4, 4, 4, 4, 4, 4, 4, 4, 4, 4, 4, 4, 4, 4, 4, 4, 4, 4, 4, 4, 4, 4, 4, 4, 1, 1, 4, 4, 4, 4, 4, 4, 4, 4, 4, 4, 4, 4, 4, 4, 4, 4, 4, 4, 4, 4, 4, 4, 4, 4, 4, 4, 4, 4],
      [4, 4, 4, 4, 4, 4, 4, 4, 4, 4, 4, 4, 4, 4, 4, 4, 4, 4, 4, 4, 4, 4, 4, 4, 4, 4, 4, 4, 4, 4, 1, 1, 4, 4, 4, 4, 4, 4, 4, 4, 4, 4, 4, 4, 4, 4, 4, 4, 4, 4, 4, 4, 4, 4, 4, 4, 4, 4, 4, 4],
      [4, 4, 0, 0, 0, 0, 0, 0, 0, 0, 1, 0, 0, 0, 0, 0, 0, 0, 0, 4, 4, 4, 4, 4, 4, 4, 4, 4, 4, 4, 1, 1, 4, 4, 4, 4, 4, 4, 4, 4, 4, 0, 0, 0, 0, 0, 0, 0, 0, 0, 1, 0, 0, 0, 0, 0, 0, 0, 4, 4],
      [4, 4, 0, 0, 0, 8, 8, 8, 8, 8, 0, 0, 0, 0, 0, 0, 0, 0, 0, 4, 4, 4, 4, 4, 4, 4, 4, 4, 4, 4, 1, 1, 4, 4, 4, 4, 4, 4, 4, 4, 4, 0, 4, 4, 4, 4, 4, 0, 0, 0, 1, 0, 0, 0, 0, 0, 0, 0, 4, 4],
      [4, 4, 0, 0, 0, 8, 15, 15, 15, 8, 0, 0, 0, 0, 0, 0, 0, 0, 0, 4, 4, 4, 4, 4, 4, 4, 4, 4, 4, 4, 1, 1, 4, 4, 4, 4, 4, 4, 4, 4, 4, 0, 4, 14, 14, 14, 4, 0, 0, 0, 1, 0, 0, 0, 0, 0, 0, 0, 4, 4],
      [4, 4, 0, 0, 0, 8, 0, 0, 0, 8, 0, 0, 0, 0, 0, 0, 0, 0, 0, 4, 4, 4, 4, 4, 4, 4, 4, 4, 4, 4, 1, 1, 4, 4, 4, 4, 4, 4, 4, 4, 4, 0, 4, 14, 14, 14, 4, 0, 0, 0, 1, 0, 0, 0, 0, 0, 0, 0, 4, 4],
      [4, 4, 0, 4, 4, 4, 4, 4, 4, 4, 4, 4, 0, 0, 0, 0, 0, 0, 0, 4, 4, 4, 4, 4, 4, 4, 4, 4, 4, 4, 1, 1, 4, 4, 4, 4, 4, 4, 4, 4, 4, 0, 4, 14, 14, 14, 4, 0, 0, 0, 1, 0, 0, 0, 0, 0, 0, 0, 4, 4],
      [4, 4, 0, 4, 14, 14, 14, 14, 14, 14, 14, 4, 0, 0, 0, 0, 0, 0, 0, 4, 4, 4, 4, 4, 4, 4, 4, 4, 4, 4, 1, 1, 4, 4, 4, 4, 4, 4, 4, 4, 4, 0, 4, 4, 1, 4, 4, 0, 0, 0, 1, 0, 0, 0, 0, 0, 0, 0, 4, 4],
      [4, 4, 0, 4, 14, 14, 14, 14, 14, 14, 14, 4, 0, 0, 0, 0, 0, 0, 0, 4, 4, 4, 4, 4, 4, 4, 4, 4, 4, 4, 1, 1, 4, 4, 4, 4, 4, 4, 4, 4, 4, 0, 0, 0, 0, 0, 0, 0, 0, 0, 1, 0, 0, 0, 0, 0, 0, 0, 4, 4],
      [4, 4, 0, 4, 14, 14, 14, 14, 14, 14, 14, 4, 0, 0, 0, 0, 0, 0, 0, 4, 4, 4, 4, 4, 4, 4, 4, 4, 4, 4, 1, 1, 4, 4, 4, 4, 4, 4, 4, 4, 4, 0, 0, 0, 0, 0, 0, 0, 0, 0, 1, 0, 0, 0, 0, 0, 0, 0, 4, 4],
      [4, 4, 0, 4, 4, 4, 4, 4, 4, 4, 4, 4, 0, 0, 0, 0, 0, 0, 0, 4, 4, 4, 4, 4, 4, 4, 4, 4, 4, 4, 1, 1, 4, 4, 4, 4, 4, 4, 4, 4, 4, 0, 0, 0, 0, 0, 0, 0, 0, 0, 0, 8, 8, 8, 8, 8, 0, 0, 4, 4],
      [4, 4, 0, 4, 14, 14, 14, 4, 0, 0, 1, 0, 0, 0, 0, 0, 0, 0, 0, 4, 4, 4, 4, 4, 4, 4, 4, 4, 4, 4, 1, 1, 4, 4, 4, 4, 4, 4, 4, 4, 4, 0, 0, 0, 0, 0, 0, 0, 0, 0, 0, 8, 15, 15, 15, 8, 0, 0, 16, 4],
      [4, 4, 0, 4, 14, 14, 14, 4, 0, 0, 0, 1, 0, 0, 0, 0, 0, 0, 0, 4, 4, 4, 4, 4, 4, 4, 4, 4, 4, 4, 1, 1, 4, 4, 4, 4, 4, 4, 4, 4, 4, 0, 0, 0, 0, 0, 0, 0, 1, 0, 0, 8, 0, 0, 0, 8, 0, 0, 4, 4],
      [4, 4, 0, 4, 14, 14, 14, 4, 0, 0, 0, 1, 0, 0, 0, 0, 0, 0, 0, 4, 4, 4, 4, 4, 4, 4, 4, 4, 4, 4, 1, 1, 4, 4, 4, 4, 4, 4, 4, 4, 4, 0, 0, 0, 0, 0, 0, 0, 1, 4, 4, 4, 4, 4, 4, 4, 4, 4, 4, 4],
      [4, 4, 0, 4, 4, 1, 4, 4, 0, 0, 0, 0, 1, 0, 0, 0, 0, 0, 0, 4, 4, 4, 4, 4, 4, 4, 4, 4, 4, 4, 1, 1, 4, 4, 4, 4, 4, 4, 4, 4, 4, 0, 0, 0, 0, 0, 0, 0, 1, 4, 14, 14, 14, 14, 14, 14, 14, 4, 4, 4],
      [4, 4, 0, 0, 0, 0, 0, 0, 0, 0, 0, 1, 0, 0, 0, 0, 0, 0, 0, 4, 4, 4, 4, 4, 4, 4, 4, 4, 4, 4, 1, 1, 4, 4, 4, 4, 4, 4, 4, 4, 4, 0, 0, 0, 0, 0, 0, 0, 16, 4, 14, 14, 14, 14, 14, 14, 14, 4, 4, 4],
      [4, 4, 0, 0, 0, 0, 0, 0, 0, 0, 1, 0, 0, 0, 0, 0, 0, 0, 0, 4, 4, 4, 4, 4, 4, 4, 4, 4, 4, 4, 1, 1, 4, 4, 4, 4, 4, 4, 4, 4, 4, 0, 0, 0, 0, 0, 0, 16, 16, 4, 14, 14, 14, 14, 14, 14, 14, 4, 4, 4],
      [4, 4, 0, 0, 0, 0, 0, 0, 0, 0, 1, 0, 0, 0, 0, 0, 0, 0, 0, 4, 22, 22, 22, 22, 22, 22, 22, 22, 22, 22, 1, 1, 22, 22, 22, 22, 22, 22, 22, 22, 4, 0, 0, 0, 16, 16, 16, 16, 0, 4, 4, 4, 1, 4, 4, 4, 4, 4, 4, 4],
      [4, 4, 0, 0, 0, 0, 0, 0, 0, 0, 1, 26, 0, 0, 0, 0, 0, 0, 0, 4, 22, 22, 27, 22, 22, 22, 22, 22, 22, 22, 1, 1, 15, 22, 22, 22, 22, 15, 22, 22, 4, 16, 16, 16, 16, 0, 0, 0, 0, 0, 1, 20, 0, 0, 0, 0, 0, 0, 4, 4],
      [4, 4, 0, 0, 0, 0, 4, 4, 4, 4, 4, 4, 4, 0, 0, 0, 0, 0, 0, 4, 22, 22, 22, 22, 22, 22, 22, 22, 22, 22, 1, 1, 22, 22, 22, 22, 22, 22, 16, 16, 16, 16, 0, 0, 0, 0, 0, 0, 0, 0, 1, 0, 0, 0, 0, 0, 0, 0, 4, 4],
      [4, 4, 0, 0, 0, 0, 4, 22, 22, 22, 22, 22, 4, 0, 0, 0, 0, 26, 0, 4, 22, 22, 22, 22, 22, 22, 22, 22, 22, 22, 1, 1, 22, 15, 22, 16, 16, 16, 16, 16, 4, 0, 0, 0, 0, 0, 20, 0, 0, 0, 1, 0, 0, 0, 0, 0, 0, 0, 4, 4],
      [4, 4, 0, 0, 0, 0, 4, 22, 22, 22, 22, 22, 4, 0, 0, 0, 0, 0, 0, 4, 22, 22, 22, 22, 22, 22, 22, 15, 22, 22, 1, 1, 16, 16, 16, 16, 22, 22, 22, 22, 4, 0, 0, 0, 0, 0, 0, 0, 0, 0, 1, 0, 0, 0, 0, 0, 0, 0, 4, 4],
      [4, 4, 0, 0, 0, 0, 4, 22, 22, 22, 22, 22, 4, 0, 0, 0, 0, 0, 0, 4, 22, 22, 22, 22, 22, 22, 22, 22, 15, 16, 16, 16, 16, 22, 22, 22, 22, 22, 22, 22, 4, 0, 0, 0, 0, 0, 0, 0, 0, 0, 1, 0, 0, 0, 0, 0, 0, 0, 4, 4],
      [4, 4, 0, 0, 0, 26, 4, 22, 22, 22, 22, 22, 4, 0, 0, 0, 0, 0, 0, 4, 22, 15, 15, 22, 22, 22, 16, 16, 16, 16, 1, 1, 22, 22, 22, 22, 22, 22, 22, 22, 4, 0, 0, 0, 0, 0, 0, 0, 0, 0, 1, 0, 0, 0, 0, 0, 0, 0, 4, 4],
      [4, 1, 1, 1, 1, 1, 4, 22, 22, 22, 22, 22, 4, 1, 1, 1, 1, 1, 1, 1, 1, 1, 1, 1, 16, 16, 16, 16, 1, 1, 17, 17, 1, 1, 1, 1, 1, 1, 1, 1, 1, 1, 1, 1, 1, 1, 1, 1, 1, 1, 1, 1, 1, 1, 1, 1, 1, 1, 1, 4],
      [4, 1, 1, 1, 1, 1, 4, 4, 4, 1, 4, 4, 4, 1, 1, 1, 1, 1, 1, 1, 1, 1, 1, 16, 16, 16, 1, 1, 1, 1, 1, 1, 1, 1, 1, 1, 1, 1, 1, 1, 1, 1, 1, 1, 1, 1, 1, 1, 1, 1, 1, 1, 1, 1, 1, 1, 1, 1, 1, 4],
      [4, 4, 0, 0, 0, 0, 0, 0, 0, 0, 1, 0, 0, 0, 0, 0, 0, 0, 0, 4, 22, 22, 16, 16, 16, 22, 22, 22, 22, 1, 1, 1, 15, 22, 22, 22, 22, 22, 22, 22, 4, 0, 0, 0, 0, 0, 0, 0, 0, 0, 1, 0, 20, 0, 0, 0, 0, 0, 4, 4],
      [4, 4, 0, 0, 0, 0, 26, 0, 0, 0, 1, 0, 0, 0, 0, 0, 0, 0, 0, 4, 22, 16, 16, 16, 22, 22, 22, 22, 15, 22, 1, 1, 22, 22, 22, 22, 22, 22, 22, 22, 4, 0, 20, 0, 0, 0, 0, 20, 0, 0, 1, 0, 0, 0, 0, 0, 0, 0, 4, 4],
      [4, 4, 0, 26, 0, 0, 0, 0, 0, 0, 1, 0, 0, 0, 0, 0, 0, 0, 0, 16, 16, 16, 22, 22, 22, 22, 22, 22, 22, 22, 1, 1, 22, 22, 22, 22, 15, 22, 22, 22, 4, 0, 0, 0, 0, 0, 20, 0, 0, 0, 1, 0, 0, 0, 0, 0, 0, 0, 4, 4],
      [4, 4, 0, 0, 0, 0, 0, 0, 0, 0, 1, 0, 0, 0, 0, 17, 17, 26, 16, 16, 16, 22, 22, 22, 22, 22, 22, 22, 22, 22, 1, 1, 22, 22, 22, 22, 22, 22, 22, 22, 4, 0, 0, 20, 0, 0, 0, 0, 0, 0, 1, 0, 20, 0, 0, 0, 0, 0, 4, 4],
      [4, 4, 0, 0, 0, 0, 0, 0, 0, 1, 0, 0, 0, 0, 0, 0, 16, 16, 16, 16, 22, 22, 22, 22, 22, 22, 22, 22, 22, 22, 1, 1, 22, 22, 22, 22, 22, 22, 22, 22, 4, 0, 0, 0, 0, 0, 0, 0, 0, 0, 1, 0, 0, 0, 0, 0, 0, 0, 4, 4],
      [4, 4, 4, 4, 4, 4, 4, 4, 1, 4, 4, 4, 4, 4, 16, 16, 16, 16, 4, 4, 4, 4, 4, 4, 4, 4, 4, 4, 4, 4, 1, 1, 4, 4, 4, 4, 4, 4, 4, 4, 4, 4, 4, 4, 4, 4, 4, 4, 4, 4, 4, 1, 4, 4, 4, 4, 4, 4, 4, 4],
      [4, 4, 0, 0, 0, 0, 0, 0, 1, 0, 0, 0, 16, 16, 16, 0, 0, 0, 0, 4, 4, 4, 4, 4, 4, 4, 4, 4, 4, 4, 1, 1, 4, 4, 4, 4, 4, 4, 4, 4, 4, 0, 0, 0, 0, 0, 0, 0, 0, 0, 0, 0, 1, 0, 0, 0, 0, 0, 4, 4],
      [4, 4, 0, 0, 0, 0, 0, 0, 1, 16, 16, 16, 16, 0, 0, 0, 0, 0, 0, 4, 4, 4, 4, 4, 4, 4, 4, 4, 4, 4, 1, 1, 4, 4, 4, 4, 4, 4, 4, 4, 4, 0, 4, 4, 4, 4, 4, 4, 4, 4, 0, 1, 0, 0, 0, 0, 0, 0, 4, 4],
      [4, 4, 0, 0, 0, 0, 16, 16, 16, 16, 0, 0, 0, 0, 0, 0, 0, 0, 0, 4, 4, 4, 4, 4, 4, 4, 4, 4, 4, 4, 1, 1, 4, 4, 4, 4, 4, 4, 4, 4, 4, 0, 4, 14, 14, 14, 14, 14, 14, 4, 0, 1, 0, 0, 0, 0, 0, 0, 4, 4],
      [4, 4, 0, 0, 16, 16, 16, 16, 1, 0, 0, 0, 0, 25, 0, 0, 0, 0, 0, 4, 4, 4, 4, 4, 4, 4, 4, 4, 4, 4, 1, 1, 4, 4, 4, 4, 4, 4, 4, 4, 4, 0, 4, 14, 14, 14, 14, 14, 14, 4, 0, 1, 0, 0, 0, 0, 0, 0, 4, 4],
      [4, 4, 16, 16, 16, 16, 0, 0, 0, 1, 0, 0, 0, 0, 0, 0, 0, 0, 0, 4, 4, 4, 4, 4, 4, 4, 4, 4, 4, 4, 1, 1, 4, 4, 4, 4, 4, 4, 4, 4, 4, 0, 4, 14, 14, 14, 14, 14, 14, 4, 4, 4, 4, 4, 4, 4, 4, 0, 4, 4],
      [4, 4, 16, 16, 0, 25, 0, 0, 0, 1, 0, 0, 0, 0, 0, 0, 0, 0, 0, 4, 4, 4, 4, 4, 4, 4, 4, 4, 4, 4, 1, 1, 4, 4, 4, 4, 4, 4, 4, 4, 4, 0, 4, 14, 14, 14, 14, 14, 14, 4, 4, 14, 14, 14, 14, 14, 4, 0, 4, 4],
      [4, 4, 0, 0, 0, 0, 0, 0, 0, 1, 0, 0, 0, 0, 0, 0, 0, 0, 0, 4, 4, 4, 4, 4, 4, 4, 4, 4, 4, 4, 1, 1, 4, 4, 4, 4, 4, 4, 4, 4, 4, 0, 4, 4, 4, 4, 1, 4, 4, 4, 4, 14, 14, 14, 14, 14, 4, 0, 4, 4],
      [4, 4, 0, 0, 0, 0, 0, 0, 0, 0, 1, 0, 0, 0, 0, 0, 0, 0, 0, 4, 4, 4, 4, 4, 4, 4, 4, 4, 4, 4, 1, 1, 4, 4, 4, 4, 4, 4, 4, 4, 4, 0, 0, 0, 0, 0, 0, 0, 0, 0, 4, 14, 14, 14, 14, 14, 4, 0, 4, 4],
      [4, 4, 0, 0, 0, 0, 25, 0, 0, 0, 0, 0, 0, 0, 0, 0, 0, 0, 0, 4, 4, 4, 4, 4, 4, 4, 4, 4, 4, 4, 1, 1, 4, 4, 4, 4, 4, 4, 4, 4, 4, 0, 4, 4, 4, 4, 4, 4, 4, 0, 4, 14, 14, 14, 14, 14, 4, 0, 4, 4],
      [4, 4, 0, 0, 0, 0, 0, 0, 0, 0, 0, 0, 0, 0, 0, 0, 0, 0, 0, 4, 4, 4, 4, 4, 4, 4, 4, 4, 4, 4, 1, 1, 4, 4, 4, 4, 4, 4, 4, 4, 4, 0, 4, 14, 14, 14, 14, 14, 4, 0, 4, 4, 4, 1, 4, 4, 4, 0, 4, 4],
      [4, 4, 0, 0, 0, 0, 0, 0, 0, 0, 0, 0, 0, 0, 0, 0, 0, 0, 0, 4, 4, 4, 4, 4, 4, 4, 4, 4, 4, 4, 1, 1, 4, 4, 4, 4, 4, 4, 4, 4, 4, 0, 4, 14, 14, 14, 14, 14, 4, 0, 0, 0, 0, 0, 0, 0, 0, 0, 4, 4],
      [4, 4, 0, 0, 0, 0, 0, 0, 0, 0, 0, 0, 0, 0, 0, 0, 0, 0, 0, 4, 4, 4, 4, 4, 4, 4, 4, 4, 4, 4, 1, 1, 4, 4, 4, 4, 4, 4, 4, 4, 4, 0, 4, 14, 14, 14, 14, 14, 4, 0, 0, 0, 0, 0, 0, 0, 0, 0, 4, 4],
      [4, 4, 0, 0, 0, 0, 0, 0, 0, 0, 0, 0, 0, 0, 0, 0, 0, 0, 0, 4, 4, 4, 4, 4, 4, 4, 4, 4, 4, 4, 1, 1, 4, 4, 4, 4, 4, 4, 4, 4, 4, 0, 4, 4, 1, 4, 4, 4, 4, 0, 0, 0, 0, 0, 0, 0, 0, 0, 4, 4],
      [4, 4, 0, 0, 0, 0, 0, 0, 0, 0, 0, 0, 0, 0, 25, 0, 0, 0, 0, 4, 4, 4, 4, 4, 4, 4, 4, 4, 4, 4, 1, 1, 4, 4, 4, 4, 4, 4, 4, 4, 4, 0, 0, 0, 0, 0, 0, 0, 0, 0, 0, 0, 0, 0, 0, 0, 0, 0, 4, 4],
      [4, 4, 0, 0, 0, 0, 0, 0, 0, 0, 0, 0, 0, 0, 0, 0, 0, 0, 0, 4, 4, 4, 4, 4, 4, 4, 4, 4, 4, 4, 1, 1, 4, 4, 4, 4, 4, 4, 4, 4, 4, 0, 0, 0, 0, 0, 0, 0, 0, 0, 0, 0, 0, 0, 0, 0, 0, 0, 4, 4],
      [4, 4, 4, 4, 4, 4, 4, 4, 4, 4, 4, 4, 4, 4, 4, 4, 4, 4, 4, 4, 4, 4, 4, 4, 4, 4, 4, 4, 4, 4, 1, 1, 4, 4, 4, 4, 4, 4, 4, 4, 4, 4, 4, 4, 4, 4, 4, 4, 4, 4, 4, 4, 4, 4, 4, 4, 4, 4, 4, 4],
      [4, 4, 4, 4, 4, 4, 4, 4, 4, 4, 4, 4, 4, 4, 4, 4, 4, 4, 4, 4, 4, 4, 4, 4, 4, 4, 4, 4, 4, 4, 4, 4, 4, 4, 4, 4, 4, 4, 4, 4, 4, 4, 4, 4, 4, 4, 4, 4, 4, 4, 4, 4, 4, 4, 4, 4, 4, 4, 4, 4]
    ]
  },
  "objects": [],
  "npcs": [],
  "monster_groups": [],
  "player_spawn": {"x": 30, "y": 25}
}